#########################################
#.......................................#
#.......................................#
#.......................................#
#.......................................#
#.......................................#
#.......................................#
#.......................................#
#........########.......########........#
#........#.....................#........#
#........#.....................#........#
#........#.....................#........#
#........#.....................#........#
#........#.....................#........#
#........#.....................#........#
#........#.....................#........#
#...................v...................#
#.................#####.................#
#.................#####.................#
#................>#####<................#
#.................#####.................#
#.................#####.................#
#...................^...................#
#........#.....................#........#
#........#.....................#........#
#........#.....................#........#
#........#.....................#........#
#........#.....................#........#
#........#.....................#........#
#........#.....................#........#
#........########.......########........#
#.......................................#
#.......................................#
#.......................................#
#.......................................#
#.......................................#
#.......................................#
#.......................................#
#.......................................#
#########################################