..#####################################..
.........................................
#.......................................#
#.................#....>vvv####.........#
#.........v.......^....>########....v...#
#....#########.........#........#...#...#
#....#.................#........#.......#
#....#.................#........#.......#
#....#..#######........#...>#...#...#...#
#....#..##....#........#........#..##...#
#....#...##<..#........#........#...#...#
#....#........#.........###vv###....^...#
#.....#.......#..........######.........#
##.....########.........................#
#..................................#....#
#......................>#<......###.....#
#....#........v................>##......#
#....^........^.....v..........##^......#
#..................###..................#
#........##.......>###<.................#
#.....>####<.......###..........##......#
#........##.........^.....v....>###<....#
#.........................^.....##......#
#......><...............................#
#............vv.......vv................#
#............##.......##.......##v......#
#...#........^##.....##^.......>###.....#
#...##.........##...##...........##.....#
#...>##.........#...#..............#....#
#...>##.........##.##......##v..........#
#...>###.........###.......>##..........#
#...###.........##^##.......##..........#
#...##..........#...#........#......v#..#
#..............##...##........#.....##..#
#............v##.....##v............##..#
#...>##.....>##.......##<............#..#
#...##......>##.......##<...............#
#.......................................#
.........##.......#............##........
..#####################################..